chapter six .	capitol . vi .	1.05
on the treatment of things that fall into the ear .	de la cura de aquo que catz en las aurelhas .	0.5
all that falls into the ear comes under four categories : mineral stone , or what resembles stone , such as iron or glass ; vegetable grain such as pea or date-stone or the like ; or liquid such as water or vinegar ; or animal .	tota causa que catz en las aurelhas es una de quatre specias , quar o es peyra mineral o causa semblant a peyra , ayssi cum ferr e veyre , o es de planta ayssi cum ceze o fava , o es causa fluxtibla ayssi cum aygua e vi agre e a lor semblantz , o alcuna bestia .	0.701434
when a stone or something of that sort that does not grow gets into the ear , turn the ear toward the sun . ~~~ if you see the stone , pour upon it a little oil of violets or sesame ; then try to get it out by moving the head or by inducing sneezing with ptarmica and keeping the nose closed at the onset of sneezing , having first made round the ear a circle of pieces of cloth or wool and drawn the ear upwards .	e donc quan peyra catz en l’aurelha o autra causa semblant de aquelas causas que no ajustan ne creysso en l’aurelha , e pausa la aurelha al solelh , e si vezes la peyra , lahoras distilla en aquela alcuna causa de oli violat o sizami , e aprop aministra la extraccio de lu , e fay le stornudar am condizi , e oppila las nars deve le aveniment de stornutacio .	0.188488
this treatment will usually bring it out .	e aprop pausa en le circuit de la aurelha alscunas pessas de drap o lana , e dextendas la aurelha a las partidas desus , quar motas veguadas es foro-getada am aquestas causas .	0.733333
but if it does not come out , try to get it out with a fine pair of tweezers shaped thus .	e si no n’es getada , lahoras aministra extraccio de lu am le instrument apelat gesti epicicarios subtil del qual aquesta es la forma :	0.38087
if it comes out with the tweezers , good .	e si es foro-getada am gesti , bo es ; e sino , lahoras aministra la extraccio de lu am onci subtil de pauca duplicacio .	0.835027
but if not , try to extract it with a fine blunt hook slightly curved .	e donc si no es foro-getada per aquo , lahoras fay una canula de aram e entromet la extremitat de la canula en le trauc de la aurelha e claus a l’enviro de la canula am cera e am oli mollificada per so que no sia ubert sino la canula .	1.03282
and if this does not bring it out , make a bronze tube and introduce the end of the tube well into the meatus of the ear and fill in round with wax softened with oil so that there may be no outlet save through the tube ; then suck it out with all your breath ; it will often come out with this .	e aprop extratz am le tieu vent am fort atraccio , quar tropas veguadas cum aquo que havem recontat .	0.190017
but if it does not come out with these means we have described , take turpentine resin or bird-lime , a very little ; twist some compact cotton wool on the end of a probe and put this on the tip ; then introduce it gently into the ear after you have dried out all the moisture from the ear .	mays si no es foro-getada en aquesta manieyra , lahoras pren de halka alumbat o de vecz aparelhat am le qual son preses les ausels una patita quantitat , e pausa aquel en la extremitat de ray , e aprop envolopa sobre aquel coto decentment pausat .	0.630446
but if your treatment so far is unavailing , then be quick and incise before an abscess or spasm supervene .	e aprop entromet aquel en le trauc de la aurelha am facilitat , e aprop excicca la aurelha de la humiditat .	0.842045
now this is the way to incise : first , the patient's cephalic vein should be cut and blood drawn , in proportion to his strength ; then seat the patient in front of you and turn his ear upwards ; make a small incision at the lobule of the ear in the depression there ( the incision should be crescent-shaped ) until you reach the stone ; then extract it with whatever instrument you may .	e donc si no es foro-getada am totas las causas las quals havem recontadas , lahoras tu coyta a talhar aquela denant que endevengua apostema caut o espasme .	0.375385
immediately afterwards sew up the incision and dress it till healed . ~~~ if the object that falls into the ear is one of those grains that grow or swell , then try to extract it by the means already mentioned .	e la manieyra de talhar aquela es que tu al comensament sancnes le malaute de la vena sephasica e extratz del sanc segon la mannieyra de la vertut de lu , e aprop fay aquel cezer entre las tuas mas e converteys l’aurelha a las partidas desus , e fen am petita fissura en la razit de la aurelha deves lo greys de lu en le loc be premegut de lu .	0.358235
if it does not respond to your efforts to get it out , take a fine narrow scalpel like this and with it attempt to cut out whatever kind of grain has entered the ear .	e sia la fissura de figura lunar entro que pervengua a la peyra , e , la peyra atrobada , osta aquela si podes am instrumentz apropriatz ; e aprop cos la fissura en aquela hora am velocitat , e cura aquela entro que sia sanat .	0.757041
you should not do this except when you are sure that this grain has become moist by reason of the vapours of the ear , so that you may cut up the grain into several small pieces .	e si la causa cazent en la aurelha es un dels gras que creysso e so inflatz , lahoras aministra la curacio e la extraccio de lu ; mays si no obezeys a tu ad eyssiment , lahoras tu pren spatum teune subtil segon aquesta forma :	0.604895
then you may extract them with a blunt hook or fine-headed tweezers , or by suction , as we have mentioned ; for their extraction will be easy .	e aministra am aquel la abscizio de aquel gra lo qual es cazut en l’aurelha .	0.572269
as for water getting into the ear , the patient should first employ sneezing excited by ptarmica , his ear having been plugged with a piece of teased-out cotton ; he should lie upon that ear in which the water is ; and if it so come out , well and good .	e no fassas aquo quan cogitas que aquel ja es humectat per la vapor del aurelha , e pausa aquel en motas pessas , e prop extratz ne aquelas am les oncis o am gesti subtil , o ab inscizio ayssi co dit havem , quar es alleujada la extraccio de lu .	0.676581
but if not , take a number of small stones about a finger's length , thin and smooth , and warm them a little in the fire ; and have the patient put one of them into the meatus of the ear and let him hop on that one foot on that side ; and , with another stone , tap upon the one put into the ear ; he should keep this up with stone after stone till all the water has come out .	mays en l’aygua la qual es intrada en l’aurelha cove que·l malaute use de sternutacio am condizi al comensament , e omple la sieua aurelha am alcu coto vielh , e jagua sobre aquela aurelha en la qual es l’aygua , e si per aquo es foro-getada , bo es ; e sino , lahoras pren tropas peyras teunas e leons segon la longitut del dit , e calfa aquelas en le foc un pauc , e le pacient entrometa una de aquelas en le trauc de la sua aurelha e saute sobre la un pe sieu de aquela partida e percussia am una autra peyra sobre la peyra la qual es dintz la aurelha .	0.700704
sometimes the water is extracted by taking a reed or quill and introducing one end into the ear ; then the other end is set alight till the greater part of it is burnt ; then repeat time after time with more quills till all the water is got out .	donc no cesse aquo am peyra entro que tota l’aygua sia foro-getada . ~~~ e ja l’aygua sira foro-getada enayssi que tu prenguas de papier o de gonc . i . , ~~~ e met la una extremetat de lu en l’aurelha e estendas l’autre extremitat am foc entro que sia comburit le may de lu .	-0.0170971
or else suck it out with a cannula as described for a stone .	e prop met i autre gonc e fay aquo tantas veguadas entro que tota l’aygua sia foro-getada , e stratz aquel am canula ayssi co desus es dit de la peyra extrasadora .	0.585714
as for the extraction of a creature getting into the ear , look to see if it is small of body , such as a flea or the like , in which case treat by those means mentioned in the section .	mays en la extraccio de bestia intrant en aquela aurelha , si es a petit cos , ayssi piussa e a lu semblant , cura aquel ayssi cum havem dit en la divisio ; mays si es de gran cos la qual causa apar al sen del vezement , lahoras aministra la extraccio de lu am gesti e oncis , e la causa de lu es pus leugiera de totas las autras causas que cazo en l’aurelha .	0.714113
but if it has a large body , conspicuous to the touch , try to get it out with tweezers and hooks ; for of all things that stick in the ear this is the easiest to extract .	mays en la extraccio de verm engendrat en la aurelha , quan tu curas aquel am aquo que havem dit en la divisio e en le tractat de distillacios e no comfereys la tua curacio , lahoras cove que tu reguardes la aurelha al solelh .	0.643333
as for the extraction of a worm generated in the ear , when you have unavailingly treated it by those methods mentioned in the section in the treatise on instillations , you will need to examine the ear in the sunlight ; and if you can see any worms , extract with tweezers or fine hooks .	e donc si apar aqui alcuna causa dels verms , lahoras extratz aquel am gesti o am onci subtils , mays si no apar deguna causa , lahoras pren una canula dejos streyta e desus ampla de la qual aquesta es la forma de lu :	0.64336
but if you cannot see any , then take a cannula of this form narrow in its lower part , broad above ; and introduce the narrow part into the ear as far as the patient can bear it ; then make strong suction through it , repeatedly , till all the worms are extracted .	e entromet la extremitat subtil en la aurelha segon la quantitat la qual suffertar puesca le malaute ; e aprop sucgeys am aquela per succio fort , e fay aquo motas veguadas , entro que totz les verms sian foro-gitatz .	0.673264
but if they do not come out in response to your treatment , plug all round the cannula with wax as bidden in treating for a stone .	mays si no obezeysso a tu al ayssiment , lahoras tu opila e claus en le circuit de la canula am cera ayssi cum havem dit ; lahoras aministre distillacios las quals han ja esproadas les antics en la curacio dels verms , e atrobaras aquo en le tractat de distillacios .	0.60069
if nothing will bring them out , employ the instillations which i mentioned as having been tried by the ancients for killing worms ; you will find that in the treatise on instillations .	e sia la tua efusio am la qual efundas les olis medicinas en la aurelha am aquest strument del qual aquesta es la forma de lu :	0.57563
the instillation of oils or drugs should be done with an instrument like this , as you will see ; you make it of silver or bronze , narrow at its lower end , with a small perforation , and wide at its upper part .	e fay aquela de argent o de eram , dejos streyt , en le qual sia un petit trauc , e am pla desus . ~~~ e donc sia cum empellent a que es en la conquavitat de la canula de continent aqui on sira necessari .	0.263293
if you wish , you may make the obturator which goes in the cannula of strong bronze ; or , if you like , take a probe and wrap cotton wool tightly round its tip ; then pour into the cannula oil , juices , or whatever of these remedies you want , with the cannula in the ear .	e si vols , pren le ray e envolveys en la extremitat de lu decentment coto , e aprop gieta oli en la concavitat del auziment , o suc de alcuna herba , o aquo que vols de aquestas medicinas en la canula — e aquela es en la aurelha — , e aprop entromet le ray am coto desus e exprem am la tua ma aquel am compressio temprada de lu entro que l’oli sia expellit en la concavitat del auziment e le malaute senta le oli dedintz .	0.825391
then introduce the probe with cotton wool on it and press moderately until the oil is ejected into the meatus and the patient feels it enter .	e aquo que sia enfundut en la aurelha sia ja scalfat am foc un petit .	0.326155
let that which you put into the ear first be slightly warmed at the fire ; and be careful that it be neither very hot nor very cold , for the ear is not suited to bear that .	e guarda te que la causa la qual distillaras en l’aurelha no sia trop frega , quar las medicinas de aurelha no suffertan aquo .	0.550962
		0.3
