chapter forty-one .	capitol . xli .	0.934615
on cauterization for sciatica .	de cauterizacio de la vena sciatica .	1.25714
when pain occurs in the hip joint and is due to cold and humidities , and the patient has been treated by those means mentioned in the section , and the treatment is ineffectual , and the pain becomes chronic , the patient should be purged of the heavy humours with foetid pills or pills of tamarind or the like ; then cauterize him .	quan dolor ve en la partida de anqua , e so causa de lu freg et humiditatz , le malaute es curat am aquo que havem dit e no confereys , e aquo es antiquat , lahoras cove que tu lacses le malaute de humors grosses am pillulas fetidas o am pillulas artificials o semblantz ; e aprop cauteriza aquel .	0.840478
the means of cauterization in this case is twofold : either with caustic chemicals or with fire .	e la manieyra del cauteri en aquela es segon dos manieyras : o cauteri am medicinas comburentz , o cauteri am foc .	0.883431
the actual cautery will serve for several methods . ~~~ one of them is to make three cauterizations over the femoral joint itself in a triangular manner ; and let them be of a fair depth ; and the space between them a finger's breadth .	sira segon dos manieyras scientas , de las quals es la una que cauterizes aquel sobre la partida de l’ancha de lu am tres cauteris triangulatz segon aquesta forma ; e fay am aquels bona profunditat .	0.265291
the cautery should be an olivary one .	e sia le spazi le qual es entre cascun cauteri la quantitat de la grossitut del dit e si le cauteri olivar o gran .	0.7375
sometimes there will also be one cauterization in the middle over the actual head of the femur , making four cauterizations in all .	mays alcunas veguadas sia le cauteri sobre le mieg loc sobre le cap de l’anquan per que son quatre cauteris .	0.778788
the burning may be done with the circular cautery which has been mentioned under cauterization of a dislocated hip ; a single cauterization so that the circle embrace the whole joint .	e si vols , cauteriza am le cercle del qual es precesida la forma en la cauterizacio de la dislocacio de l’anqua , la i que sia cercle continent e comburey la ispicitut de tota la codena .	0.841507
burn through the whole thickness of the skin .		-0.3
this is the form of cauterization for sciatica when the pain is localized in the hip joint and does not extend to the femur and the leg .	e aquesta es la manieyra de cauteri in ciatiqua quan dolor es adherent al anqua e no es estenduda entro a la coyssa .	0.969474
but if it extends to the femur and the leg , cauterize him over the thigh with two burns at the place where the patient indicates the pain to be ; and one burn four fingers above the great tendon of the heel , a little to the outer side .	mays si es estenduda entro a la coyssa , lahoras cauteriza aquel am dos cauteris sobre la coyssa sobre le loc al qual envireys le malaute que es la dolor ; e am un cauteri sobre la cavilha per quatre ditz un pauc deves la part cilvestra .	0.907483
the cautery should be edged , and the depth of the burn only to the thickness of the skin .	e si le cauteri cutellar , e sia la profunditat del cauteri segon la quantitat de la ispicitut de la codena .	0.805675
but if the patient points out that the pain reaches to the toes , then cauterize where he has indicated to you , with a punctate cautery , three or four or more perforations if he needs it .	e si le malaute envireys que la dolor es estenduda entro al loc prop les ditz des pes , lahoras cauteriza aquel aqui on envireys am cauteri per tres puntz o quatre o mays si indigeys de aquel .	0.894118
if he indicates that the pain is under the knee towards the shank , give him one burn there with the edged cautery .	e si le malaute envireys dolor esser dejos le donolh ves la coyssa , lahoras cauteriza aquel aqui am un cauteri cutellar .	1.15266
be careful in all your cauterizing not to carry the cautery so far as to burn a nerve or a large artery ; for thence arises grave harm , or crippling , to the patient .	e guarda te en tota cauterizacio que no ultimes am le cauteri en tant que comburas nervi o gran arceria , e que per aquo a tu es sobre le malaute mal noccument o contraccio .	0.691973
i myself have seen more than one person cauterizing over the tendon of achilles , the cauterization being excessive , and the leg was affected with a defluxion of humours which eventually reached the foot and the whole was riddled ; after that came diarrhoea , and , after that , death .	e yeu ja e vist un e autre de aquels les quals cauterizero sobre la cavilha e ultimero en la cauterizacio , e la cama foc inflada entro que la tumor aconseguit lo pe , e foc perforat e corromput tot le pe .	0.901626
if there is pain in two places , cauterize both in this way .	e aprop accidic fort solucio de ventre , e aprop aquo la mort .	1.28776
certain learned doctors have mentioned a cauterization applicable to the hip in this manner : make a bowl of iron with a diameter of half a span ; the thickness of the edge of its mouth should be that of a date-stone or a little less .	e si la dolor es en dos partidas ensemps cauteriza quascuna segon aquesta manieyra .	0.359683
another bowl is introduced into this , and a third into that ; and there is a distance between the bowls of a thumb-joint .	e diysero les savis alcus en la cauterizacio de anqua cauteri del qual aquesta es la manieyra : fay semblant a cercle de ferr del qual le cercuit sia la maytat de un palm ; e sia deves le sieu orrifici segon la grossesa de un os de datil o mens un pauc .	0.570923
the bowls are open on both sides ; and the depth of them should be a thumb-joint or two . ~~~ make an iron handle for them firmly fitted to the bowls . ~~~ here is the figure .	e dedintz aquel cercle sia un autre tertz ; e sia le spazi le qual es entre lor la quantitat del notz del pous ; e sian aquels cercles ubertz de dos partidas ; e sia la longitut de aquels cays un notz o dos notz , e fay en aquels margue de ferr decentment apparelhat en les cercles ; e aquesta es la forma de lu :	0.173389
then heat this cautery in the fire until it is hot and sends out sparks ; and so let it be applied to the hip , the patient lying on his sound side ; and thus three circular cauterizations will be produced at a time .	aprop sia ignit en le foc entro que s’enrogesisca e gete scintillas , e aprop sia pausat sobre la partida del anqua , le malaute colcat sobre le latz sa .	0.9348
afterwards let it be for three days ; then smear with butter and leave the wound open for a while ; then treat with ointment till it heals .	e donc cauteriza aquel am tres cauteris redontz en una veguada .	0.66453
the author of this book says that we very rarely employ this method of cauterization on account of the ugliness and dread appearance of it , and because we find few patients who will endure it .	e aprop layssa aquel per tres jorns ; aprop emplastre aquel am boder e layssa la plagua uberta per trops dias ; e aprop cura aquel am enguentz entro que sia sanat .	0.594295
nevertheless , it is one of the best cauteries for him who can endure it and is correctly treated by it .	diys albucasis : o , filhs , de aquesta specia de cauteri pauc havem usat per la terror del reguardament de lu , e per aquo que paucs havem trobatz les quals reguardan sobre lu .	0.483069
cauterization with caustics is thus : make two bowls like the ring into which a door-hinge descends , either of bronze or iron .	mays dels bos cauteris a lu qui les sufferta , et atroba am aquel le loc de lu .	0.545238
the height of their sides should be two thumb-joints or thereabouts , and they should be separated about a finger's breadth ; they should be open above and below , and joined one to another thus .	mays cauteri am medicinas adhurentz es que tu fassas dos cercles haventz armula perforada en la qual deyssen le guaffo de la porta de ferr ; sia la longuitut de la paretz en la nauteza de lor sian dos nozes o quays aquels .	0.34168
then place them over the capsule of the hip joint , the patient lying upon his sound side , and press down hard ; then pour caustic fluid between the two rings—it should have been heated slightly—and keep it there for the space of one hour by the sand-clock .	e si le spazi le qual es entre quascu la quantitat de la grossitut del dit ; e sian ubertz dejos e desus , e sian que contenguan se entre lor segon aquesta forma :	0.779744
the patient must endure the sting and heat of it ( for he will find it stings like fire ) till the causticity diminishes .	e aprop pausa sobre la partida de la anqua le malaut jasent sobre le latz sa , e comprem la tua ma sobre la partida de la anqua ; e aprop pren de aygua cauda e fon la entre dos cercles , e la qualiditat de aquela sia am le foc petit a petit , e te aquela per la quantitat de una hora , e sufferta le malaute la mordicacio e la adhustio de lu — quar aquel atrobo mordicacio ayssi cum de foc — entro que cesse la mordicacio .	0.975524
then remove your hand with the instrument and wash away the caustic from the whole capsule with pure water .	e aprop eleva la tua ma am le instrument et abstergeys l’aygua cauda de tota la anqua am aygua dousa .	0.70327
let be for three days and apply butter to it till the eschar comes away ; and let the pus flow from it for a few days , for that will be more conducive to healing .	e aprop leyssa aquel per tres jorns e pausa sobre aquel boder entro que sia la negror de la adhustio remauguda , e leyssa aquo per alcus jorns , e correra de lu poyredura ; aquest es derier en juvament .	0.929131
then treat with ointment till it heals .	e aprop cura aquel am enguentz entro que sia sanat .	0.887255
if the pain extends to the hip joint or the leg , make a form in some material that will hold the fluid for that , just as you did for the capsule of the femur .	e si la dolor es extenduda entro la coyssa o la camba , fay a lu estatua en lu que contengua aygua segon que es feyt en la anqua engualment .	1.10625
now this is the description of the caustic ; i have already put it in my treatise on the improvement of drugs : take of the salt of potash and quicklime , equal parts , and beat them both up well and put them into a new earthen pot , in the bottom of which you have made a small hole of a size to take a probe . ~~~ place under that pot another one , glazed .	e aquesta es la manieyra de aygua cauda , e yeu ja he scrit aquela en le tractat de la rectificacio de medicinas .	0.366667
pour enough water on the quicklime and potash to cover them to a finger's breadth after you have pressed them well together with your hand ; and leave the pot until the caustic fluid has passed down into the bottom of the glazed pot .	recipe de alcali e de caus no extinta de amdos ana partida una , e trissa les e pausa en una ola nova de la qual la partida dejos sia perforada per un petit trauc , segon la quantitat que intre en lu ray .	0.702818
then collect all that fluid and pour it upon a fresh lot of lime and potash . ~~~ thus will the water be very caustic indeed .	e pausa dejos le fons de la ola autra ola enveyriada , e gete sobre aquel alcali e caus viva de aygua doussa la qual cobra aquels per un dit , e pus que tu compremes aquels am la tieua ma per bona compressio , e leyssa la hola que deyssenda de lu aygua aguda en la partida dejos a la ola enveyriada .	0.376333
this is used for many medical procedures and for the cauterization of all members , as it has the very same action as fire itself .	e aprop ajusta tota aquela aygua , e geta la sobre autra caus viva e autre alcali renovelatz , quar aquela lahoras sira de mot forta acuitat , la qual es aministrada en motas operacios de medicina e en cauterizacio dels autres membres , quar operacio fa de foc .	0.888889
there are other drugs too with which the capsule of the femur is cauterized , such as thapsia and mel anacardinum and inunction of lime with soap .	e so de las medicinas alcunas am las quals es cauterizat ancha , ayssi cum tezizic e mel anacrat e caus am sabo enayssi que sian mesclatz .	1.0029
galen , quoting one of the men of old , mentions a treatment for pain in the thigh and sciatica and he makes much of it , asserting that no other treatment was necessary , and that it would heal on one application , so much so that the patient would be carried into the bath and would go out completely cured .	e gualia recontet de un home dels antics la operacio e la curacio am la qual es curada dolor de anqua e de vena sciatica , e magnifiquet mot be esser de aquel , e diys que no hac necessitat de autra curacio , e quar es sanat per una veguada ayssi cum recomtec , quar fort leu aquel intrec en banh e eysic ja sa d’aquel .	1.09085
the method is as follows : take fresh green water-cress or new dry water-cress if fresh is not to be had ; beat it up well with some fat and apply it to the hip where it hurts , or to the leg or thigh , and bind up .	et es que sia pres de certarragi vert , e si no es atrobat vert , sia presa figua recent ; e mot sia trissada am un pauc de grays e sia pausat sus la anqua en la qual es la dolor , o en la coyssa , o en la camba , e sia liat .	0.824055
then let be for three hours or until the patient feels a diminishing of the caustic ; and then let him be taken to the bath .	e sia layssat per la cantitat de tres horas o per la quantitat que·l malaute centa cedacio de la adhustio .	0.668182
when his body is bedewed with sweat , get him into the pool ; then the pain will vanish and he will be cured . ~~~ if he is not cured repeat the plaster in ten days' time and then he will be healed .	e aprop met aquel en banh e donc quan le cors de lu sia enrozat , entromet aquel en le sol , quar la dolor cessa e es sanat .	0.532836
but you must know that no one should have cauterization with these drugs except after evacuation of the bowel .	e sapias que no cove que alcu use de cauteri am aquestas medicinas sino aprop la evacuacio del cors .	0.692427
dioscorides has said that cauterization with goats' dung is beneficial for sciatica . ~~~ the cauterization is carried out in this manner : take wool soaked in old oil and put it into the cleft which is between the thumb and the forearm but nearer to the forearm .	mays ja escorides diysec que quan am fenda de cabra la vena stretica es cauterizada , aprofieyra a lu mo be ; e sia le cauteri am lu segon aquesta manieyra : sia presa lana e sia enbeguda en oli antic , e sia pausat entre le pous del pe e entre le fossil .	0.381371
then take the dried dung of a goat and expose it to fire until it glows like a coal .	e aprop pren fenda de cabra secca e emflasma aquela am foc entro que sia fayta carbo ; e aprop pausa lu sobre la lana e leysa la entro que sia estengida .	0.906397
place it on the piece of wool , and leave till it cools , then replace it with another , and so on until the sensation has reached the hip joint by way of the forearm , and the pain stops .	e aprop itera aquo , e no cessas far aquo entro que·l scintiment de la mordicacio pervengua entro al anqua e repausa la dolor .	0.977885
this kind of cautery is called 'the dung cautery' .	et aquesta manieyra de cauteri es apelat cauteri de vaquas .	0.516913
		0.3
