chapter sixty-two .	capitol lxii .	0.934615
on opening a watery hernia .	de seccio sobre ernia acoza .	0.716071
a watery hernia is a collection of fluid in the white membrane lying beneath the skin surrounding the testicle , which is called the scrotum .	hernia ayguoza no es sino agregacio de humiditat en le ciphac blanc lo qual es dejos la codena dels genetius contenent le huou , e es nompnat ciphac .	0.953955
sometimes it has a capsule of its own which nature has formed alongside the testis so that one would think it another testicle ; it may also form between the skin of the scrotum and the white membrane which we mentioned ; however , this occurs very rarely .	e alcunas veguadas es en le propri pannicol le qual a lu preparec natura en la partida del huou , entro que sia cuyat que ja es autre huou ; e es la codena del genetiu entre le ciphac blanc le qual havem dit , e no es aquo sino tart .	0.857609
this hernia arises from a weakness occurring in the testicles and this matter drains into it ; sometimes it happens from a blow upon the testicles .	e la generacio de aquest hernia es per debelitat la qual accideys als genetius , per que ad aquels es efundunda aquesta materia , e alcunas vetz accideys per percuscio fayta sobre les genetius .	0.850174
the fluid is of different colours , sometimes yellowish , sometimes blood-red , sometimes like lees , black , and sometimes the fluid is watery-pale ; this actually is the commonest .	e aquesta humiditat es havent motas colors , quar la color de lu o es declinant a citrina o a sanguinent , o rog , o es negra feculenta , o es ayguosa blanqua , e es aquo que es mays .	1.00852
now these are the signs whereby we know where the fluid is collecting : if it be in the tunica albugínea , as we have said , the tumour will be round and slightly elongated like the shape of an egg . ~~~ the testis is not apparent since the fluid hems it in all round .	e les senhals per les quals es saubut on es aquesta agreguacio de aygua so aquestz : quar si es en le ciphac blanc le qual havem dit , lahoras le apostema es redon declinant un pauc a longitut ayssi cum figura de huou , e appar le genetiu , quar la humiditat conte aquel de tota part .	0.289437
but if the fluid be contained in a capsule of its own the tumour will be round , to one side of the testicle ; therefore one imagines that it is another testicle .	e si la humiditat es en le propri pannicol , lahoras le apostema es redon am partida del huou e per aysso hom estima que es autre huou .	0.83945
if the fluid be situated between the skin of the scrotum and the tunica albugínea it will be obvious to the touch .	e si la humiditat es entre la codena dels genetius e·l ciphac blanc , lahoras catz dejos le centiment .	0.839664
if you wish to know the colour of the fluid , take a sample from the tumour by means of the four-sided exploring needle which has been figured previously ; and by what comes out in the track of the explorer you may know the colour of the contained fluid .	e cum tu vols la cognicio de la color de la humiditat , lahoras tu esproa la color de la humiditat en le apostema am entromes cayrat del qual la forma es precedida ; e segon aquo que es eyssit en le vestigi del entromes , jutga de aquo que es dedintz lu .	0.930182
when we begin operative treatment the patient should be told to be venesected , if possible , if you see that he is of a plethoric bodily habit .	donc quan nos vinem a la curacio de lu am ferr , lahoras cove que comandem al malaute que sia fleubotomat si aquo es a tu possibla , e vezes le cos de lu ple .	1.0822
then let him lie on his back upon something a little raised , and have a heap of material placed beneath him .	e aprop sia resupinat sobre le sieu dos sobre alcuna causa un pauc auta , e pausa dejos lu motz draps .	0.800052
then sit down on his left side , and bid an assistant sit on his right side and draw out his penis toward one side or other of the scrotum and toward the hypogastrium .	e aprop setz tu sobre la part sinistra de lu , e comanda al ministra que segua a la dextra de lu , le qual extenda la sua vergua a hun de dos latz a la codena dels genetius e a la partida del mirac del ventre .	0.818889
then take a broad scalpel and make a longitudinal incision in the scrotum , from the middle almost to the pubes .	e aprop pren spatum lat e scindeys la codena dels genetius del mieg loc per la longitut entro prop le pentenilh .	0.952174
the incision should be straight , on a parallel with the median raphe of the scrotum , down to the tunica albuginea , and dissect away from it carefully lest you cut it .	e sia fayta la seccio segon rectetut engualment distant de la linha que deveseys la pel dels genetius , entro que pervengua al ciphac blanc comprehendent .	0.71011
you should dissect chiefly on the side where the testicle is most adherent , and take your dissection as far as possible .	e excorja aquel , e observa , e guarda te per aysso que tu no inscidas aquel ; e la tua excoriacio am la qual aquel excorjas per partida jassia que sia suspenduda am le huou mays e subtilment escruta am la excoriacio segon la quantitat a tu possibla .	0.87203
then open up the membrane containing the fluid with a wide perforation and draw off all the fluid .	e aprop perfora le ciphac ple de aygua am perforacio ampla , e extratz tota l’aygua .	0.915238
then with hooks separate the two edges of the incision and draw the membrane upwards but do not touch the skin overlying the testes ; then cut away the membrane in whatever way is possible , either as a whole or piecemeal , particularly the side piece ; for unless you use the utmost diligence in cutting it away you cannot be certain that the fluid will not come back .		-0.3
if the testicle should protrude from its covering of skin while you are operating , return it when you have finished cutting the membrane ; then bring together the two edges of your incision with a suture .	e aprop separa entre doas labias de la seccio am uncis , e exten le ciphac a las partidas desus ; e no toques la codena les genetius comprehendent , e inscideys le ciphac en aquela manieyra que es a tu possible .	1.22131
then dress with the usual dressings for wounds until healed . ~~~ if you find the testicle corrupted by some other disease , you will have to tie off the vessels which are in the suspensor , for fear of haemorrhage .	e inscideys aquel am la sua totalitat o en pessas , e majorment le sieu latz subtil , quar si tu no perscrutas exquisidament la inscizio de lu , no es fayta segurtat que la aygua no retorne .	0.318255
then cut the testicle from the suspensor and remove it and dress as we said above . ~~~ if the accumulation of fluid be on both sides you may know it to be a double hydrocele ; so make another incision on the other side as you did for the first .	mays si le huou procezeys de aquela defora de la sua codena en la ora de la tua operacio , lahoras quan tu auras complida la seccio del ciphac , retorna dedintz aquel , e aprop ajusta las doas labias de la codena dels genetius am sutura , e aprop cura aquel ayssi cum las autras plagua , entro que sia sanat .	0.216374
if it is convenient for you to make one operation of it , do so .	e si atrobas le huou corromput per autra malautia , lahoras cove que tu lies les vayssels les quals so sore le suspensori , e extrat le huou , e aprop cura aquel am aquo que havem dit .	0.788235
then wipe away the blood and apply to the incisions wool that has been soaked in olive-oil or oil of roses and on that again more wool that has been soaked in wine and oil , and spread that over the testicles and over the hypogastrium ; and over that again folded pieces of linen forming pads and bind them down with a bandage having six heads .	mays si l’aygua es agreguada en doas partidas esemps , lahoras sapias que doas son las ernias ; donc inscideys aquela partida segon que has feyt en l’autra engualment ; e si es a tu vist que sia una opera , lahoras tu la fay .	0.459259
two pieces of cloth should be taken and sewn together and packed in between with carded wool to this pattern . ~~~ the ends by means of which it is attached should be made of cotton or soft wool and should be drawn tight at the waist of the breeches .	e aprop tu abstergiys le sanc , e entramet en las seccios lana submersa en oli o en oli rozat ; e pausa deforo autra lana la qual tu as submersa en vi e oli , e expandeys aquela sobre dos genetius e·l mirac del ventre ; e pausa desobre draps doblatz e pulvils , e lia aquels desobre am liament le qual es segon aquesta forma :	0.40597
one of the ends you take over the seat toward the back : the second end you take toward the pubes , the two ends round the thighs below , and the remaining two ends over the groin , and the whole is bound up tight with the belt of the breeches . ~~~ this rupture may also be treated by cautery instead of surgery . ~~~ this will mean taking a knife-edged cautery and cutting with it the skin of the testicles ; it should be hot , as we told you before , and used until the white membrane covering the hydrocele be exposed .	e aprop sian preses dos draps e sian humplitz de lana carmenada segon aquesta semblansa ; e sian faytas las extremitatz am les quals es premut de coto o de lana humida , e sian agreguatz am strectura en le braguier de las braguas , e la una de las extremitatz prengua del cul entro al dos , e la segonda prengua a la partida del pantenilh , e dos extramitatz sobre dos coyssas dejos e dos extramitatz autras sobre dos angonars , e tota extrictura sia ajustada en le braguier de las braguas .	0.204525
then take another cautery of this type , which resembles the greek letter tau ; and with it perforate that membrane .	e alcunas veguadas aquesta hernia es medicada artificialment am cauteri en loc de seccio am ferr ; e es que tu prenguas cauteri cutellar subtil e que inscidas am aquel la codena dels ginitius , e es ignit segon que havem recomtat entro que sia descubert le ciphac blanc contenent la aygua , e lahoras tu pren cauteri segon aquesta forma :	0.914119
it should be hot so as to draw out all the humidity .	e es asemblat a letra greca .	0.825
then stretch the membrane with hooks , dissect away the capsule with the cautery and cut it away as best you are able until you have completely removed it .	e aprop perfora am aquel ciphac , e es ignit entro que tota la humiditat sia fora-gitada .	0.71266
but be careful that the heat do not touch the testicle .	e aprop exten le ciphac am uncis , e excorja am uncis , e excorja am cauteri subtil ignit ; e inscideys aquel segon que es a tu possible entro que eradiques tot lu ; e guarda te del huou que·l foc no·l toque .	0.902007
you should know that this operation is safer , further removed from the danger of haemorrhage , and better , than operation by incision .	e sapias que aquesta operacio es pus salva e pus longinqua de flux de sanc , e milhor que operacio am seccio .	1.09073
if , while operating either with the knife or the cautery , you are hindered by an inflammatory swelling or haemorrhage or anything else , you should deal with all of them by suitable treatment in accordance with what has been said before .	mays si a tu fa contrarietat apostema caut en la hora de seccio o en hora de cauteri , o flux de sanc , lahoras cove que tu cures qual contrarietat fa a tu per aquo , am curacio la qual conveneys a lu segon que es dit .	0.787984
if the patient be timid and will not suffer this operation on account of its unpleasantness , then treat by perforation as i shall now describe .	mays si le malaute es pauruc , e no spera la segonda operacio per la sua horribilitat , lahoras administra perforacio segon que yeu recomti aquo ; e es quan es certificat deves tu , per aquo que havem dit de las significacios , que aquela hernia es ayguosa .	1.03929
when by the signs we have mentioned you are certain that the hernia is watery , you should seat the patient on a high chair and pierce the tumour in its lower part with a broad scalpel .	lahoras cove que tu fassas sezer le malaute sobre alcuna cezelha elevada , aprop perfora le apostema en la partida pus bassa de lu am spatum lat , e pausa la perforacio segon la longitut del cos .	0.972308
the perforation should run in the long axis of the body , and it should be an ample opening to let all the fluid run out .	e sia la apercio ampla entro que corro tota l‘aygua .	0.688636
then put cotton on the place and bind it on and leave it so as to soak up the rest of the fluid ; then dress the wound until it heals .	e aprop pausa sobre le loc coto e lia aquel e layssa aquel , per so que corro le romanent de l’aygua . ~~~ e aprop cura aquel entro que la plagua sia sanada .	0.330556
but if the fluid fail to flow out when the opening is made , which would be due to the tunica albuginea's obtruding into the opening and preventing the outlet of the fluid , you should then introduce into the wound a goose-quill or an instrument such as is used for ascites , already described ; or else the opening should be widened a little .	mays si contrarietat es a la egrecio de l’aygua en aquela hora tu perforas aquela : e aquo no es fayt sino per aquo quar le pannicol blanc en le orrifici de la plagua fa contrarietat e prohibeys le eyssiment de l’aygua , lahoras cove que tu metas en la plagua pena o instrument am la qual es extrayta l’aygua dels ydropitz , la forma del qual es precedida ; o ajusta en la opprecio de la plagua un petit .	0.832804
but you should know that after six months or so the fluid may come back and collect again ; when it does so , perforate him in exactly the same manner ; so will the patient prolong his life .	e sapias que l’aygua retorna , e es agueguada aprop vi meses o enaviro aquels ; e cum es agreguada , lahoras sia perforat segon aquela meteyssa manieyra , quar le malaute ayssi passara les sieus dias .	0.891855
		0.3
